





