





